W W W W W W W W W W W W W W W W W W W W W W W W W W W W
W L L L L L L L L L L L L W W L L L L L L L L L L L L W
W L W W W W L W W W W W L W W L W W W W W L W W W W L W
W P W W W W L W W W W W L W W L W W W W W L W W W W P W
W L W W W W L W W W W W L W W L W W W W W L W W W W L W
W L L L L L 1 L L L L L L L L L L L L L L 3 L L L L L W
W L W W W W L W W L W W W W W W W W L W W L W W W W L W
W L W W W W L W W L W W W W W W W W L W W L W W W W L W
W L L L L L L W W L L L L W W L L L L W W L L L L L L W
W W W W W W L W W W W W G W W G W W W W W L W W W W W W
W W W W W W L W W W W W G W W G W W W W W L W W W W W W
W W W W W W L W W G G O G G G G A G G W W L W W W W W W
W W W W W W L W W G W W W G G W W W G W W L W W W W W W
W W W W W W L W W G W G G G G G G W G W W L W W W W W W
W W W W W W L G G G W G G G G G G W G G G L W W W W W W
W W W W W W L W W G W G G G G G G W G W W L W W W W W W
W W W W W W L W W G W W W W W W W W G W W L W W W W W W
W W W W W W L W W G G S G G G G C G G W W L W W W W W W
W W W W W W L W W G W W W W W W W W G W W L W W W W W W
W W W W W W L W W G W W W W W W W W G W W L W W W W W W
W L L L L L L L L L L L L W W L L L L L L L L L L L L W
W L W W W W L W W W W W L W W L W W W W W L W W W W L W
W L W W W W L W W W W W L W W L W W W W W L W W W W L W
W P L L W W 4 L L L L L L G H L L L L L L 2 W W L L P W
W W W L W W L W W L W W W W W W W W L W W L W W L W W W
W W W L W W L W W L W W W W W W W W L W W L W W L W W W
W L L L L L L W W L L L L W W L L L L W W L L L L L L W
W L W W W W W W W W W W L W W L W W W W W W W W W W L W
W L W W W W W W W W W W L W W L W W W W W W W W W W L W
W L L L L L L L L L L L L L L L L L L L L L L L L L L W
W W W W W W W W W W W W W W W W W W W W W W W W W W W W
D D D D D D N N N N D D D D D D D M N N N N D D D D D D